de=the
en=and
een=a
het=it
in=in
te=too
ik=I
hebben=to have
hij=he
niet=not
op=on
dat=that
voor=before
er=there
je=you
zullen=shall
kunnen=can/to be able to
haar=her
of=or
wat=what
gaan=to go
hem=him
komen=come
dan=then
zo=so
moeten=should
mijn=my
zij=she
deze=this
we=we
meer=more
dit=this
maken=to make
staan=stand
goed=good
ander=other
doen=to do
me=me
u=you
mij=me
laten=to let
al=already
daar=there
denken=to think
toen=then (past)
geven=to give
hoe=how
nu=now
vinden=find
man=man
jaar=year
hier=here
wij=we
houden=to keep
zitten=to sit
hand=hand
lang=long
twee=two
dag=day
eerst=first
alleen=only
brengen=bring
beginnen=to begin
zelf=self
horen=to hear
nieuw=new
laat=late
voelen=to feel
plaats=place
leven=life
huis=house
vallen=fall
moeder=mother
spreken=to speak
woord=word
ja=yes
wanneer=when
vader=father
werk=work
elk=each
ver=far
later=later
vertellen=to tell
jij=you
drie=three
oud=old
soms=sometimes
wereld=world
uur=hour
naam=name
soort=kind
werken=to work
vol=full
welk=which
boek=book
deur=door
ding=thing
nee=no
water=water
feit=fact
wachten=to wait
leren=to learn
open=open
probleem=problem
groep=group
jong=young
wit=white
zodat=so that
lachen=laugh
bed=bed
verder=further
moment=moment
staat=state
vriend=friend
week=week
laatste=last
helpen=to help
licht=light
diep=deep
nacht=night
langs=along
beide=both
jullie=you
vrij=free
gevoel=feeling
half=half
tafel=table
school=school
vier=four
dood=death
sociaal=social
hard=hard
wijn=wine
maand=month
mond=mouth
reden=reason
voet=foot
idee=idea
rol=role
jou=you
antwoord=answer
slapen=to sleep
plan=plan
meestal=mostly
straat=street
persoon=person
schouder=shoulder
luisteren=listen
invloed=influence
hart=heart
zoon=son
bezig=busy
arm=arm
tien=ten
los=loose
vijf=five
minuut=minute
liefde=love
sommige=some
direct=directly
relatie=relationship
systeem=system
proces=process
menen=mean
derde=third
drinken=drink
contact=contact
functie=function
warm=warm
vinger=finger
kleur=color
pijn=pain
glas=glass
artikel=article
eind=end
persoonlijk=personally
rood=red
dokter=doctor
zee=sea
groeien=to grow
koud=cold
leiden=to lead
staan=to stand
familie=family
periode=period
sinds=since
resultaat=result
normaal=normal
rond=round
organisatie=organization
speciaal=special
patiënt=patient
broer=brother
leveren=to deliver
hopen=to hope
totaal=total
zes=six
blauw=blue
stap=step
karakter=character
theorie=theory
bloed=blood
beter=better
dochter=daughter
stappen=to step
droom=dream
meter=meter
steen=stone
hulp=help
rest=rest
muziek=music
maaltijd=meal
openen=to open
bank=bank
papier=paper
hoop=hope
minister=minister
wind=wind
koffie=coffee
stoppen=stop
oor=ear
informatie=information
methode=method
lip=lip
positie=position
alle=all
enorm=enormous
foto=photo
film=movie
activiteit=activity
modern=modern
geluk=luck
basis=base
zuster=sister
wakker=awake
tante=aunt
vuur=fire
prijs=price
reactie=reaction
praktijk=practice
neus=nose
terrein=terrain
koning=king
zingen=to sing
vliegen=fly
cultuur=culture
missen=to miss
politie=law enforcement
wensen=to wish
factor=factor
begin=get started
succes=good luck
kosten=to cost
natuur=nature
hotel=hotel
studie=study
vriendelijk=friendly
aspect=aspect
figuur=figure
ontbreken=lack
nationaal=national
ziek=sick
term=term
geef=give
rennen=To run
Engels=english
effect=effect
plant=plant
product=product
slaap=sleep
tekst=text
knie=knee
geboren=born
telefoon=phone
individueel=individually
structuur=structure
helft=half
trein=train
praktisch=practical
zomer=summer
winnen=to win
conclusie=conclusion
baby=baby
internationaal=international
eiland=island
meester=master
kwaliteit=quality
vullen=to fill
individu=individual
vervullen=fulfill
plaatsen=place
bespreken=discuss
discussie=discussion
sigaret=cigarette
vis=fish
absoluut=absolutely
historisch=historical
nummer=number
schaduw=shadow
leiding=leadership
kat=cat
universiteit=university
mezelf=myself
fase=phase
technisch=technical
positief=positive
programma=program
leider=leader
wapen=weapon
literatuur=literature
brood=bread
medisch=medical
officier=officer
rivier=river
dansen=to dance
interessant=interesting
markt=market
officieel=officially
baas=boss
schoen=shoe
boot=boat
vloer=floor
dromen=to dream
winter=winter
maan=moon
kilometer=kilometers
wens=wish
miljoen=million
seconde=second
rijk=rich
bier=beer
collega=colleague
actie=action
plezier=pleasure
psychologie=psychology
techniek=technic
vechten=to fight
gras=grass
pad=path
financieel=financial
beïnvloeden=to influence
actief=active
ster=star
machine=machine
energie=energy
gouden=golden
nek=neck
rusten=to rest
auteur=author
procent=per cent
museum=museum
realiseren=realize
cultureel=cultural
bus=bus
directeur=director
materiaal=material
produceren=to produce
veld=field
gast=guest
dubbel=double
zand=sand
centrum=centre
productie=production
westen=west
specifiek=specific
koel=cool
wassen=To wash
klant=client
tong=tongue
argument=argument
negatief=negative
kaas=cheese
titel=title
visie=vision
persoonlijkheid=personality
kust=coast
danken=to thank
radio=radio
wijd=wide
jezelf=yourself
interesseren=to be interested
olie=oil
thee=tea
risico=risk
president=president
groen=green
honger=hungry
traditioneel=traditional
adres=address
experiment=experiment
fundamenteel=fundamentally
advies=advice
klimmen=to climb
typisch=typical
stijl=style
top=top
traditie=tradition
heet=hot
psychologisch=psychological
computer=computer
generatie=generation
bodem=bottom
student=student
relatief=relatively
categorie=category
kalm=calm
eindigen=to end
goederen=goods
formuleren=to formulate
instrument=instrument
klas=class
combinatie=combination
publiceren=to publish
landschap=landscape
warmte=warmth
televisie=television
organiseren=to organize
patroon=pattern
agent=agent
emotie=emotion
orgaan=organ
provincie=province
detail=detail
restaurant=restaurant
wild=wild
pijnlijk=painful
station=station
klassiek=classic
sector=sector
eindeloos=endless
emotioneel=emotional
studeren=to study
symbool=symbol
luitenant=lieutenant
passeren=pass
motief=motive
fabriek=factory
lijst=list
serieus=serious
logisch=logical
mama=mom
vluchten=to flee
noorden=north
bijten=to bite
vorming=formation
café=cafe
object=object
Holland=Holland
kamp=camp
dun=thin
ideaal=ideal
juni=june
accepteren=to accept
initiatief=initiative
bitter=bitter
verspreiden=to spread
verbieden=to forbid
consequentie=consequence
oktober=October
westers=western
jongeman=young man
hoed=hat
zenden=to send
zondag=sunday
theoretisch=theoretically
psycholoog=psychologist
pers=press
terras=terrace
dood=dead
crisis=crisis
pot=pot
operatie=operation
partner=partner
suiker=sugar
gemeen=mean
plaat=plate
stijf=stiff
economie=economy
bruin=brown
sneeuw=snow
kruis=cross
automatisch=automatically
project=project
hut=hut
fruit=fruit
communicatie=communication
dom=dumb